XXXXXXXXXXXXXXXXXXXXXXXXXXXXXXXXXXXXXXXXXXXXXXXXXXXXXXXXXXXXXXXXXXXXXXXXXXXXXXXXXXXXXXXXXXXXXXXXXXXX
XXXXXXXXXXXXXXXXXXXXXXXXXX XXXXXXXXXXXXXXXXXXX XXXXXXXXXXXXXX XXXXXXXXXXXXXXXXXXXXXXXXXXXXXXXXXXXXXX
X                                                                                                  X
XXXXXXXXXXXXXXXXXXXXXXXXXX XXXXXXXXXXX XXXXXXX XXXXXXXXXXXXXX XXXXXXXXXXXXXXX XXXXXXXXXXXXXXXXXXXXXX
XXXXXXXXXXXXXXXXXXXXXXXXXX XXXXXXXXXXX XXXXXXX XXXXXXXXXXXXXX XXXXXXXXXXXXXXX XXXXXXXXXXXXXXXXXXXXXX
XXXXXXXXXXXXXXXXXXXXXXXXXX XXXXXXXXXX   XXXXXX XXXXXXXXXXXXXX XXXXXXXXXXXXXX   XXXXXXXXXXXXXXXXXXXXX
X                                                                                                  X
XX XX XXXXXXXX XX XXXXXXX XXXX XXXXXX XXXXXXXX XX XXX XXX XXXXXXXXXXXXXXXXXXXXXXXXXXXXXXXX XXXXXXX X
XX XX XXXXXXXX XX XXXXXXX XXXX XXXXXX XXXXXXXX XX XXX XXX XXXXXXXXXXXXXXXXXXXXXXXXXXXXXXXX XXXXXXX X
XX XX XXXXXXXX XX XXXXXXX  XXX XXXXXX XXXXXXXX XX XXX                                              X
XX XX XXXXXXXX XX XXXXXXX      XXXXXX XXXXXXXX        XXX XXXX XXXXXXXXXXXXXX XXXXXXXXXXXX XXXXXXX X
XX XX XXXXXXXX XX XXXXXXX  XXX XXXXXX XXXXXXXX XX XXX XXX XXXX XXXXXXXXXXXXXX XXXXXXXXXXXX XXXXXXX X
XX XX XXXXXXXX XX XXXXXXX XXXX XXXXXX XXXXXXXX XX  XX XXX XXXX XXXXXXXXXXXXXX XXXXXXXXXXXX XXXXXXX X
XX XX           X XXXXXXX XXXX XXXXXX XXXXXXX  XX     XXX XXX                                      X
XX XX XXX XXXX            XXXX XXXXXX          XX  XX XXX      XXXXXXXXXXXXXX XXXXXXXXXXXXXXXXXXXX X
XX XX XXX XXXX XX XXX XXX XXXX XXXXXX XXXX XX  XX XXX XXX XXX  XXXXXXXXXXXXXX XXXXXXXXXXXXXXXXXXXX X
XX XX XXX XXXX XX XXX XXX XXXX XXXXXX XXXX XXX XX XXX XXX XXXX XXXXXXXXXXXXXX XXXXXXXXXXXXXXXXXXXX X
XX XX XXX XXXX XX XXX XXX XXXX XXXXXX XXXX XXX XX XXX XXX XXXX XXXXXXXXXXXXXX XXXXXXXXXXXXXXXXXXXX X
XX XX XXX XXXX XX XXX XXX             XXXX XXX XX XXX XXX                                          X
XX XX XXX XXXX XX XXX XXX XXXX XXXXXX XXXX XXX XX XXX XXX XXXX XXXXXXX XXXXXXXXXXXXXXXXXXXXXXXXXXX X
XX XX XXX XXXX XX XXX XXX XXXX XXXXXX XXXX XXX XX XXX XXX XXXX XXXXXXX XXXXXXXXXXXXXXXXXXXXXXXXXXX X
XX XX XXX  XXX                 XXXXXX XXXX XXX XX XXX XXX XXXX XXXXXXX XXXXXXXXXXXXXXXXXXXXXXXXXXX X
XX XX XXX      XXXXXX XXX XXXX XXXXXX XXXX XXX XX XXX XXX XXXX XXXXXXX XXXXXXXXXXXXXXXXXXXXXXXXXXX X
XX XX XXX  XXX XXXXXX XXX XXXX XXXXXX XXXX XXX XX XXX XXX XXXX XXXXXXX XXXXXXXXXXXXXXXXXXXXXXXXXXX X
XX XX XXX XXXX XXXXXX XXX XXXX XXXXXX XXXX XXX XX XXX XXX XXXX XXXXXXX XXXXXXXXXXXXXXXXXXXXXXXXXXX X
XX XX XXX XXXX XXXXXX XXX XXXX XXXXXX XXXX XXX XX XXX XXX XXXX XXXXXXX XXXXXXXXXXXXXXXXXXXXXXXXXXX X
XX XX XXX XXXX                        XXXX XXX XX XXX XXX XXXX XXXXXXX XXXXXXXXXXXXXXXXXXXXXXXXXXX X
XX XX XXX XXXX XXX XX XXXXXXXX XX XXX XXXX XXX XX XXX XXX XXXX XXXXXXX XXXXXXXXXXXXXXXXXXXXXXXXXXX X
XX XX XXX XXXX XXX XX XXXXXXX  XX XXX XXXX XXX XX XXX XXX XXX  XXXXXXX XXXXXXXXXXXXXXXXXXXXXXXXXXX X
X     XXX XXXX XXX XX  XXXXX          XXXX XXX XX XXX XXX XX   XXXXXXX XXXXXXXXXXXXXXXXXXXXXXXXXXX X
XX XX XXX XXXX XXX XX          XX XXX XXXX XXX XX XXX                                              X
XX XX XXX XXXX XXX XX  XXXXXXX XX XXX XXXX XXX XX XXX XXXXXXXXXXXXXXXX XXX XX XXXX XXXXXXXXXXXXXXX X
XX XX XXX XXXX XXX XX XXXXXXXX XX XXX XXXX XXX XX XXX XXXXXXXXXXXXXXXX XXX XX XXXX XXXXXXXXXXXXXXX X
XX XX XXX XXXX XX  XX XXXXXXXX XX          XXX     XX XXXXXXXXXXXXXXXX XX  XX XXXX XXXXXXXXXXXXXXX X
XX XX XXX XXXX     XX XXXXXXXX XX XXX XXXX XXX XX                          XX XXXX XXXXXXXXXXXXXXX X
XX XX XXX XXXX XX  XX XXXXXXXX XX XXX XXXX XXX XX XXX XXXXXXXXXXXXXXXX XX  XX XXXX XXXXXXXXXXXXXXX X
XX XX XXX XXXX XXX XX  XXXXXXX XX XXX XXXX XXX XX  XX XXXXXXXXXXXXXXXX XXX XX XXXX XXXXXXXXXXXXXXX X
XX XX XXX XXXX XXX XX          XX XXX XXXX XXX XX     XXXXXXXXXXXXXXXX XXX XX XXXX XXXXXXXXXXXXXXX X
XX XX XXX XXXX XXX XX  XXXXXXX        XXXX XXX XX  XX XXXXXXXXXXXXXXXX XXX XX XXXX XXXXXXXXXXXXXXX X
XX XX XXX XXXX XXX XX XXXXXXXX XX XXX XXXX XXX XX XXX XXXXXXXXXXXXXXXX XXX XX XXXX XXXXXXXXXXXXXXX X
XX XX XXX XXXX XXX XX XXXXXXXX XX XXX XXXX XXX XX XXX XXXXXXXXXXXXXXXX XXX XX XXXX XXXXXXXXXXXXXXX X
XX XX XXX XXXX XXX XX XXXXXXX  XX XXX          XX XXX XXXXXXXXXXXXXXXX XXX XX XXXX XXXXXXXXXXXXXXX X
XX XX XXX XXXX                 XX XXX XXXX XXX XX XXX XXXXXXXXXXXXXXXX XXX XX XXXX                 X
XX XX XXX XXXX XXX XX XXXXXXX  XX XXX XXXX XXX XX XXX XXXXXXXXXXXXXXXX XXX XX XXXX XXXXXXXXXXXXXXX X
XX XX XXX XXXX XXX XX XXXXXXXX XX XXX XXXX XXX XX XXX XXXXXXXXXXXXXXXX XXX XX XXXX XXXXXXXXXXXXXXX X
XX XX XXX XXX  XXX XX XXXXXXXX XX XXX             XXX XXXXXXXXXXXXXXXX XXX XX XXXX XXXXXXXXXXXXXXX X
XX XX          XXX             XX XXX XXXXXXXX XX XXX XXXXXXXXXXXXXXXX XXX         XXXXXXXXXXXXXXX X
XX XX XXX XXX  XXX XX XXXXXXXX XX XXX XXXXXXXX XX XXX XXXXXXXXXXXXXXXX XXX XX XXXX XXXXXXXXXXXXXXX X
XX XX XXX  XXX XXX XX XXXXXXXX XX XXX XXXXXXXX XX XXX XXXXXXXXXXXXXXXX XXX XX XXXX XXXXXXXXXXXXXXX X
XX XX XXX      XXX XX XXXXXXXX     XX XXXXXXXX XX XXX XXXXXXXXXXXXXXXX XXX XX XXXX XXXXXXXXXXXXXXX X
XX XX XXX  XXX XXX XX XXXXXXXX XX              XX XXX XXXXXXXXXXXXXXXX XXX                         X
XX XX XXX XXXX XXX XX XXXXXXXX XX XXX XXXXXXXX XX XXX XXXXXXXXXXXXXXXX XXX XXXXXXX XXX XXXXXXXXXXX X
XX XX XXX XXXX XXX XX XXXXXXXX XX XXX XXXXXXXX XX XXX XXXXXXXXXXXXXXXX XXX XXXXXXX XXX XXXXXXXXXXX X
XX XX XXX XXXX XXX XX XXXXXXXX XX XXX XXXXXXXX        XXXXXXXXXXXXXXXX XXX                         X
XX XX XXX XXXX XXX XX XXXXXXXX XX XXX XXXXXXXX XX XXX XXXXXXXXXXXXXXXX XXX XXXXXXX XXX XXXXXXXXXXX X
XX XX XXX XXXX XXX XX XXXXXXXX XX XXX XXXXXXXX XX XXX XXXXXXXXXXXXXXXX XXX XXXXXXX XXX XXXXXXXXXXX X
XX XX XXX XXXX XXX XX XXXXXXXX XX XXX XXXXXXXX XX XXX XXXXXXXXXXXXXXX  XXX XXXXXXX XXX XXXXXXXXXXX X
X              XXX XX XXXXXXXX XX XXX XXXXXXXX XX XXX                                              X
XXXXX XXXXXXXX XXX XX XXXXXXXX XX XXX XXXXXXXX XX XXX XXXXXXX XXX XXX  XXX XXXXXXXXXXXXXXXXXXXXXXX X
XXXXX XXXXXXXX XXX XX XXXXXXXX XX XXX XXXXXXXX XX XXX XXXXXXX XXX XXXX XXX XXXXXXXXXXXXXXXXXXXXXXX X
XXXXX XXXXXXX  XXX XX XXXXXXXX XX  XX XXXXXXXX XX XXX XXXXXXX XXX XXXX XXX XXXXXXXXXXXXXXXXXXXXXXX X
XXXXX          XXX XX XXXXXXXX XX     XXXXXXXX XX XXX XXXXXXX          XXX XXXXXXXXXXXXXXXXXXXXXXX X
XXXXX XXXXXXX  XXX XX XXXXXXXX XX  XX XXXXXXXX        XXXXXXX XXX XXXX XXX XXXXXXXXXXXXXXXXXXXXXXX X
XXXXX XXXXXXXX XXX XX XXXXXXXX XX XXX XXXXXXXX XX XXX XXXXXXX XXX XXXX XXX XXXXXXXXXXXXXXXXXXXXXXX X
XXXXX XXXXXXXX XXX XX XXXXXXXX XX XXX  XXXXXXX XX XXX XXXXXXX XXX XXXX XXX XXXXXXXXXXXXXXXXXXXXXXX X
XXXXX  XXXXXXX XXX XX XXXXXXXX XX XXX          XX XXX XXXXXXX XXX XXXX XXX XXXXXXXXXXXXXXXXXXXXXXX X
XXXXX          XXX XX XXXXXXXX XX XXX  XXXXXXX XX XXX                      XXXXXXXXXXXXXXXXXXXXXXX X
XXXXX  XXXXXXX XXX XX XXXXXXXX XX XXX XXXXXXXX XX XXX XXXXXXX XXXXXXXX XXX XXXXXXXXXXXXXXXXXXXXXXX X
XXXXX XXXXXXXX XXX XX XXXXXXXX XX XXX XXXXXXXX XX XXX XXXXXXX XXXXXXXX XXX XXXXXXXXXXXXXXXXXXXXXXX X
XXXXX XXXXXXXX XXX XX XXXXXXXX XX XXX XXXXXXXX                                                     X
XXXXX XXXXXXXX        XXXXXXXX XX XXX XXXXXXXX XX XXX XXXXXXXXXXX   XXXXX   XXXXXXXXXX XXXXXXXXXXX X
XXXXX XXXXXXXX XXX XX XXXXXXXX XX XXX XXXXXXXX XX XXX XXXXXXXXXXXX XXXXXXX XXXXXXXXXXX XXXXXXXXXXX X
XXXXX XXXXXXXX XXX XX XXXXXXXX XX XXX XXXXXXXX XX XXX XXXXXXXXXXXX XXXXXXX XXXXXXXXXXX XXXXXXXXXXX X
X                                     XXXXXXXX XX XXX XXXXXXXXXXXX XXXXXX   XXXXXXXXX   XXXXXXXXXX X
XXXXXXXXXXXXXX XXXXXXXXXXXXXXXXXXXXXX XXXXXXXX                                                     X
XXXXXXXXXXXXXX XXXXXXXXXXXXXXXXXXXXXX XXXXXXXX XXXXXX XXX XXXX XXXXXX XXXXXXX XXXXXXX XXXXXXXXXXXXXX
XXXXXXXXXXXXXX XXXXXXXXXXXXXXXXXXXXXX XXXXXXXX XXXXXX XXX XXXX XXXXXX XXXXXXX XXXXXXX XXXXXXXXXXXXXX
X                                              XXXXXX XXX XXXX XXXXXX XXXXXXX XXXXXXX XXXXXXXXXXXXXX
XXXXXX XXXXXX XXXXXXXX XXXXXXXXXX XXX XXX XXXX XXXXXX XXX XXXX XXXXXX XXXXXXX XXXXXXX XXXXXXXXXXXXXX
XXXXXX XXXXXX XXXXXXXX XXXXXXXXXX XXX XXX XXXX XXXXXX XXX XXXX XXXXXX XXXXXXX XXXXXXX XXXXXXXXXXXXXX
XXXXXX XXXXXX XXXXXXXX XXXXXXXXXX XXX XXX XXX  XXXXXX XXX XXXX XXXXXX XXXXXXX XXXXXXX XXXXXXXXXXXXXX
XXXXXX XXXXXX XXXXXXXX XXXXXXXXXX XXX XXX XX   XXXXXX XXX XXX  XXXXXX XXXXXXX XXXXXXX XXXXXXXXXXXXXX
XXXXXX XXXXXXHXXXXXXXX XXXXXXXXXX XXX          XXXXXX XXX      XXXXXX                              X
XXXXXX XXXXXX XXXXXXXX XXXXXXXXXX XXX XXX XXXX XXXXXX XXX XXX  XXXXXX XXXXXXX XXXXXXX XXXXXXXXXXXX X
XXXXXX XXXXXX XXXXXXXX XXXXXXXXXX XXX XXX XXXX XXXXXX XXX XXXX XXXXXX XXXXXXX XXXXXXX XXXXXXXXXXXX X
XXXXXX XXXXX   XXXXXX   XXXXXXXX      XXX XXXX XXXXXX XXX XXXX XXXXXX XXXXXXX XXXXXXX XXXXXXXXXXXX X
X                                 XXX XXX XXXX XXXXXX                 XXXXXXX XXXXXXX              X
XXXXXX XXXXXXXXXXXXXXXXXXXXXXXXXX XXX XXX XXXX XXXXXX XXX XXXX XXXXXX XXXXXXX XXXXXXX XXXXXXXXXXXX X
XXXXXX XXXXXXXXXXXXXXXXXXXXXXXXXX XXX XXX XXXX XXXXXX XXX XXXX XXXXXX XXXXXXX XXXXXXX XXXXXXXXXXXX X
XXXXXX XXXXXXXXXXXXXXXXXXXXXXXXXX XXX XXX XXXX XXXXXX XXX  XXX XXXXXX XXXXXXX XXXXXXX XXXXXXXXXXXX X
XXXXXX XXXXXXXXXXXXXXXXXXXXXXXXXX XXX XXX XXXX XXXXXX XXX      XXXXXX XXXXXXX XXXXXXX XXXXXXXXXXXX X
XXXXXX XXXXXXXXXXXXXXXXXXXXXXXXXX XXX XXX XXXX XXXXXX XXX  XXX XXXXXX XXXXXXX XXXXXXX XXXXXXXXXXXX X
XXXXXX XXXXXXXXXXXXXXXXXXXXXXXXXX XXX XXX XXXX XXXXXX XXX XXXX XXXXXX XXXXXXX XXXXXXX XXXXXXXXXXXX X
XXXXXX XXXXXXXXXXXXXXXXXXXXXXXXXX XXX XXX XXXX XXXXXX XXX XXXX XXXXXX XXXXXXX                      X
XXXXXX XXXXXXXXXXXXXXXXXXXXXXXXXX XXX XXX XXXX XXXXXX XXX XXXX XXXXXX XXXXXXX XXXXXXXXXXXXXXXXXXXX X
XXXXXX XXXXXXXXXXXXXXXXXXXXXXXXXX XXX XXX XXXX XXXXXX XXX XXXX XXXXXX XXXXXXX XXXXXXXXXXXXXXXXXXXX X
XXXXXX XXXXXXXXXXXXXXXXXXXXXXXXXX XXX XXX XXXX XXXXXX XXX XXXX XXXXXX XXXXXXX XXXXXXXXXXXXXXXXXXXX X
X                                     XXX XXXX XXXXXX XXX XXXX XXXXXX XXXXXXX XXXXXXXXXXXXXXXXXXXX X
XXXXXXXXXXXXXXXXXXXXXXXXXXXXXXXXX XXX XXX XXXX XXXXXX                                              X
XXXXXXXXXXXXXXXXXXXXXXXXXXXXXXXXXXXXXXXXXXXXXXXXXXXXXXXXXXXXXXXXXXXXXXXXXXXXXXXXXXXXXXXXXXXXXXXXXXXX