XXXXXXXXXXXXXXXXXXXX
X                  X
X  XXXXXX XXXX X   X
X XXXXXXX XXXX XX XX
X XXXXXXX XXXX XX XX
X                  X
X XXX XXX XXXX XX XX
X XXX XXX XXXX XX XX
X XXX XXX XXXX XX XX
X  X   XXHXXX      X
X                  X
X  XXXXXXXXXXX XX XX
X XXXXXXXXXXXX XX XX
X  XXXXXXXXXX   X XX
X                  X
X  XXXXXXXXXX XXX  X
X XXXXXXXXXXX XXXX X
X                  X
X XXXXXXXXXXX XXXX X
XXXXXXXXXXXXXXXXXXXX