XXXXXXXXXXXXXXXXXXXXXXXXXXXXXXXXXXXXXXXXXXXXXXXXXXXXXXXXXXXX
X                                                         XX
X XXXX XXXXXX   XXXXXX XXX XXXXXXXXXX   XX XX  XX      XX XX
X XXXX XXXXXXX XXXXXXX XXX XXXXXXXXXXX XXX XXX XXX XX XXX XX
X XXXX XXXXXXX XXXXXXX XXX XXXXXXXXXXX XXX XXX XXX XX XXX XX
X XXXX XXXXXXX XXXXXXX XXX XXXXXXXXXXX XXX XXX XXX XX XXX XX
X XXXX                                 XXX XXX XXX XX XXX XX
X XXXX XXXXXXX XXXXXXX XXX XXXXXXXXXXX XXX XXX XXX XX XXX XX
X XXXX XXXXXXX XXXXXXX XXX XXXXXXXXXXX XXX XXX XXX XX XXX XX
X XXXX XXXXXX   XXXXXX XXX XXXXXXXXXXX XXX XXX XXX XX XXX XX
X                                                         XX
X XXXX XX XXXXXXX XXXX XX XXXXXXXXXXXXXXXX XXX XXX XXX XX XX
X XXXX XX XXXXXXX XXXX XX XXXXXXXXXXXXXXXX XXX XXX XXX XX XX
X  XXX XX XXXXXXX XXXX XX XXXXXXXXXXXXXXXX XXX XXX XX   X XX
X                      XX XXXXXXXXXXXXXXXX XXX            XX
X  XXX XX XXXXXXX XXXX XX XXXXXXXXXXXXXXXX XXX XXX XXXXXX XX
X XXXX XX XXXXXXX  XXX XX XXXXXXXXXXXXXXXX XXX XXX XXXXXX XX
X XXXX XX XXXXXXX   XX X   XXXXXXXXXXXXXX  XXX XXX XXXXXX XX
X                                                          X
XXXXXX XXXXXX XXXXXXXX XXXXXXX XXXXXXXXXX XXX XXXXXXXXXXX XX
XXXXXX XXXXXX XXXXXXXX XXXXXXX XXXXXXXXXX XXX XXXXXXXXXXX XX
X                                                         XX
XXXXXX XXXXXX  XXXXXXX XXXXXXX XX XX   XXXXXX XXX   XXXXX XX
XXXXXX XXXXXXX XXXXXXX XXXXXXX XX XXX XXXXXXX XXXX XXXXXX XX
XXXXXX XXXXXXX XXXXXXX XXXXXXX XX XXX XXXXXXX XXXX XXXXXX XX
XXXXXX                 XXXXXXX XX XXX XXXXXXX XXXX XXXXXX XX
XXXXXX XXXXXXX XXXXXXX XXXXXXX        XXXXXXX XXXX XXXXXX XX
XXXXXX XXXXXXX XXXXXXX XXXXXXX XX XXX XXXXXXX XXXX XXXXXX XX
XXXXXX XXXXXX  XXXXXXX XXXXXXX XX XXX XXXXXXX XXXX XXXXXX XX
XXXXXX XXXXX   XXXXXXX XXXXXXX XX XXX XXXXXXX XXXX XXXXXX XX
X                                                         XX
XXXXXX XX XXXXXXXXXXXX XXXXXXXXXXXXXX XXXXXXXXXXXXXXXXXXX XX
XXXXXX XX XXXXXXXXXXXX XXXXXXXXXXXXXX XXXXXXXXXXXXXXXXXXX XX
XXXXXX XX XXXXXXXXXXXX                                    XX
XXXXXX                 XXXXXXX XXXXXX XXXXXXXXXXXXXXXXXXX XX
XXXXXX XX XXXXXXXXXXXX XXXXXXX XXXXXX XXXXXXXXXXXXXXXXXXX XX
XXXXXX XX XXXXXXXXXXXX XXXXXXX XXXXXX XXXXXXXXXXXXXXXXXXX XX
XXXXX   X XXXXXXXXXXXX XXXXXX   XXXX   XXXXXXXXXXXXXXXXXX XX
X                                                          X
XX XXXXXXX XXXXXXXXXXXXXXXXXXX XX XXXXXXXXXXXXXXXXXXXXXXX XX
XX XXXXXXX XXXXXXXXXXXXXXXXXXX XX XXXXXXXXXXXXXXXXXXXXXXX XX
X                            H                            XX
XX XX XXXX XX XXXXXXXXXXXXXXXX XX XXXXXXXXXXXXXXXXXXX XXX XX
XX XX XXXX XX XXXXXXXXXXXXXXXX XX XXXXXXXXXXXXXXXXXXX XXX XX
XX XX XXXX XX XXXXXXXXXXXXXXXX XX XXXXXXXXXXXXXXXXXXX XXX XX
XX XX XXXX XX XXXXXXXXXXXXXXXX                            XX
XX XX XXXX XX XXXXXXXXXXXXXXXX X   XXXXXXXXXXXXXXXXXX XXX XX
XX XX XXXX XX XXXXXXXXXXXXXXXX XX XXXXXXXXXXXXXXXXXXX XXX XX
X  XX XXXX XX XXXXXXXXXXXXXXXX XX XXXXXXXXXXXXXXXXXXX XXX  X
X  XX XXXX XX XXXXXXXXXXXXXXXX XX XXXXXXXXXXXXXXXXXXX XXX  X
X  XX XXXX XX XXXXXXXXXXXXXXXX XX XXXXXXXXXXXXXXXXXXX XXX  X
XX XX XXXX XX XXXXXXXXXXXXXXXX XX XXXXXXXXXXXXXXXXXXX XXX XX
XX XX XXXX XX XXXXXXXXXXXXXXXX XX XXXXXXXXXXXXXXXXXXX XXX XX
XX                             XX XXXXXXXXXXXXXXXXXXX XXX XX
XX XX XXXXXXX XX   XXXXXXXXXXX XX XXXXXXXXXXXXXXXXXXX XXX XX
XX XX XXXXXXX XXX XXXXXXXXXXXX XX XXXXXXXXXXXXXXXXXXX XXX XX
XX XX XXXXXXX XXX XXXXXXXXXXXX XX XXXXXXXXXXXXXXXXXXX XXX XX
X                                                          X
XXXXXXXXX      XXXXXXXXXXXXXXXXXXXXXXXXXXXXXXXXXXXXX   XX XX
XXXXXXXXXXXXXXXXXXXXXXXXXXXXXXXXXXXXXXXXXXXXXXXXXXXXXXXXXXXX